1111111111111
101000C000001
101P100010001
10000010C01E1
1111111111111
