1111111111111
1PCE000010001
100C100000001
1111111111111
