1111111111111
10000C00000E1
100P000000001
1000000000001
1111101111111
